#####################
#     X             #
#    X     X        #
#         # #       #
#          #     #  #
#####################