#####################
#V    X             #
#    X     X        #
#         # #       #
#          #     #  #
#####################