#####################
#     X             #
#    X P   X        #
#         # #    P  #
#          #     #  #
#####################