#####################
#OX                 #
#                   #
#    P    # #       #
#          #     #  #
#####################